%%%%%%%%%%%%%%%%%%%%%%%%%%%%%%%%%%
%.........#............#.........%
%.#####.#.#####.##.#####.#.#####.%
%.#.....#................#.....#.%
%.#.######.#####..############.#.%
%.#..#...###...#..#...#...#S#..#.%
%.##.#.#.#.#.#.#..#.#.#.#.#.#.##.%
%....#.#.....#......#...#...#....%
%.##.#.#.#.#.#.#..#.#.#.#.#.#.##.%
%.#..#...###...#..#...#...#.#..#.%
%.#.######.#####..############.#.%
%.#............................#.%
%.#####...#####.##.#####...#####.%
%................................%
%###########.########.###########%
%...#......#....#................%
%.#.#.#.#######.#.##############.%
%.#...#.........#.##...........#.%
%.#########.##.##..#.#.#######.#.%
%.........#..#..##.#.#.#...#...#.%
%######.#.##.##.#..#.#.#.#...#.#.%
%.......#....#..#.##.#.#######.#.%
%.#######.#.##.##....#.....#...#.%
%.........#..#..########.#...#.#.%
%######.######..##.....#.#######.%
%.#.....#..........###.#####.####%
%...###.#.######.###...#...#.#...%
%.###...#.#....#.#...###.#.#.#.#.%
%.#...#.#.#.##...#.##..#.#.#...#.%
%.#E###.#...##.#.#...#.#.#.#.#.#.%
%.......#.#....#.###.#...#.#...#.%
%.#######.######.#...#.#.#######.%
%..................#...#.........%
%%%%%%%%%%%%%%%%%%%%%%%%%%%%%%%%%%