%%%%%%%%%%%%%%%%%
%.#.....S.......%
%.#...##########%
%.#...#.........%
%....###........%
%...#.#.#...#...%
%.....#...####..%
%..####.....#...%
%.....#.....#...%
%...#...#....#..%
%.#####....#....%
%.#...#..#...#..%
%...#......#..E.%
%%%%%%%%%%%%%%%%%